10,9,0,8,1
0000000077
0000000770
0000007700
0000077000
0000770000
0007700000
0077000000
0770000000
3700000000
