9,5,4,2,1
033333330
333333333
373333373
333333333
033333330
